00,00,00,00,00,00,00,00,00,00,00,00,00,00,00,00,00,00,00,00,00,00,00,00,00
00,00,00,00,00,00,00,00,00,00,00,00,00,00,00,00,00,00,00,00,00,00,00,00,00
00,00,00,26,00,00,00,00,00,00,00,00,00,00,00,00,00,00,00,00,00,00,00,00,00
00,00,00,00,35,00,00,00,00,00,00,00,00,00,00,00,00,00,00,00,00,00,00,00,00
00,00,00,00,00,00,00,00,00,00,00,00,00,00,00,00,00,00,00,00,00,00,00,00,00
00,00,00,00,00,00,00,00,00,00,00,00,00,00,00,00,00,00,00,00,00,00,00,00,00
00,00,00,00,00,00,00,00,00,00,00,00,00,00,00,00,00,00,00,00,00,00,00,00,26
00,00,00,00,00,00,00,00,00,00,00,00,00,00,00,00,00,00,00,00,00,00,00,00,00
00,00,00,00,00,00,00,00,26,00,00,00,00,00,00,00,00,00,00,00,00,00,00,00,00
00,00,00,00,00,00,00,00,00,00,00,00,00,00,00,00,00,00,00,00,00,00,00,00,00
00,00,00,00,00,00,00,00,35,00,00,00,00,00,00,00,00,00,00,00,00,00,00,00,00
00,00,00,00,00,00,00,00,00,00,00,00,00,00,00,00,00,00,00,00,00,00,00,00,00
00,26,00,00,00,00,00,00,00,00,00,00,00,00,00,00,00,00,00,00,00,00,00,00,00
00,00,00,00,00,00,00,00,00,00,00,00,00,00,00,00,00,00,00,00,00,00,00,00,00
00,00,00,00,00,00,00,00,00,00,00,00,00,00,00,00,00,00,00,00,00,00,00,00,00
00,00,00,00,00,00,00,00,00,35,00,00,00,00,00,00,00,00,00,00,00,00,00,00,00
00,00,00,00,00,00,00,00,00,00,00,00,00,00,00,00,00,00,00,00,00,00,00,00,00
00,00,00,00,00,00,00,00,00,26,00,00,00,00,00,00,00,00,00,00,00,00,00,00,00
00,00,00,00,00,00,00,00,00,00,00,00,00,00,00,00,00,00,00,00,26,00,00,00,00
00,00,00,00,00,00,00,00,00,00,00,00,00,00,00,00,00,00,00,00,00,00,00,00,00

00,00,00,00,00,00,00,00,00,00,08,00,00,00,00,00,00,00,00,03,42,43,44,45,46
00,00,00,00,00,00,00,00,00,00,08,00,00,00,00,00,00,00,00,03,52,53,54,55,56
00,00,00,00,00,00,00,00,00,00,28,00,00,00,00,00,00,00,00,03,00,00,00,00,00
00,00,00,00,00,00,00,00,00,00,08,00,00,00,00,00,00,00,00,03,00,00,00,00,00
00,00,00,00,00,00,00,00,00,00,08,00,00,00,00,00,00,00,00,03,00,00,00,00,00
00,00,00,00,00,00,00,00,00,00,28,00,00,00,00,00,00,00,00,03,00,00,00,00,00
00,00,00,00,00,00,00,00,00,00,08,00,00,00,00,00,00,00,00,03,00,00,00,00,00
00,00,00,00,00,00,00,00,00,00,08,00,00,00,00,00,00,00,00,03,00,00,00,00,00
00,00,00,00,00,00,00,00,00,00,08,00,00,00,00,00,00,00,00,03,00,00,00,00,00
00,00,00,00,00,00,00,00,00,00,28,00,00,00,00,00,00,00,00,03,00,00,00,00,00
00,00,00,00,00,00,00,00,00,00,42,43,44,45,46,42,43,44,45,22,00,00,00,00,00
00,00,00,00,00,00,00,00,00,00,52,53,54,55,56,52,53,54,55,32,00,00,00,00,00
00,00,00,00,00,00,00,00,00,00,00,00,00,00,00,00,00,00,00,00,00,00,00,00,00
00,00,00,00,00,00,00,00,00,00,00,00,00,00,00,00,00,00,00,00,00,00,00,00,00
00,00,00,00,00,00,00,00,00,00,00,00,00,00,00,00,00,00,00,00,00,00,00,00,00
00,00,00,00,00,00,00,00,00,00,00,00,00,00,00,00,00,00,00,00,00,00,00,00,00
00,00,00,00,00,00,00,00,00,00,00,00,00,00,00,00,00,00,00,00,00,00,00,00,00
00,00,00,00,00,00,00,00,00,00,00,00,00,00,00,00,00,00,00,00,00,00,00,00,00
00,00,00,00,00,00,00,00,00,00,00,00,00,00,00,00,00,00,00,00,00,00,00,00,00
00,00,00,00,00,00,00,00,00,00,00,00,00,00,00,00,00,00,00,00,00,00,00,00,00

00,00,00,00,00,00,00,00,00,00,00,00,00,00,00,00,00,00,00,00,00,00,00,00,00
00,00,00,00,00,00,00,00,00,00,00,00,00,00,00,00,00,00,00,00,00,00,00,00,00
00,00,00,00,00,00,00,00,00,00,00,00,00,00,00,00,00,00,00,00,00,00,00,00,00
00,00,00,00,00,00,00,00,00,00,00,00,00,00,00,00,00,00,00,00,00,00,00,00,00
00,00,00,00,00,00,00,00,00,00,00,00,00,00,00,00,00,00,00,00,00,00,00,00,00
00,00,00,00,00,00,00,00,00,00,00,00,00,00,00,00,00,00,00,00,00,00,00,00,00
00,00,00,00,00,00,00,00,00,00,00,00,00,00,00,00,84,85,00,00,00,00,00,00,00
00,00,00,00,00,00,00,00,00,00,00,00,00,00,00,00,94,95,00,00,00,00,00,00,00
00,00,00,00,00,00,00,00,00,00,00,00,00,00,00,00,00,00,00,00,00,00,00,00,00
00,00,00,00,00,00,00,00,00,00,00,00,00,00,00,00,00,00,00,00,00,00,00,00,00
00,00,00,00,00,00,00,00,00,00,00,00,00,00,00,00,00,00,00,00,00,00,00,00,00
00,00,00,00,00,00,00,00,00,00,00,00,00,00,00,00,00,00,00,00,00,00,00,00,00
00,00,00,00,00,00,00,00,00,00,00,00,00,00,00,00,00,00,00,00,00,00,00,00,00
00,00,00,00,00,00,00,00,00,00,00,00,00,00,00,00,00,00,00,00,00,00,00,00,00
00,00,00,00,00,00,00,00,00,00,00,00,00,00,00,00,00,00,00,00,00,00,00,00,00
00,00,00,00,00,00,00,00,00,00,00,00,00,00,00,00,00,00,00,00,00,00,00,00,00
00,00,00,00,00,00,00,00,00,00,00,00,00,00,00,00,00,00,00,00,00,00,00,00,00
00,00,00,00,00,00,00,00,00,00,00,00,00,00,00,00,00,00,00,00,00,00,00,00,00
00,00,00,00,00,00,00,00,00,00,00,00,00,00,00,00,00,00,00,00,00,00,00,00,00
00,00,00,00,00,00,00,00,00,00,00,00,00,00,00,00,00,00,00,00,00,00,00,00,00

10,00,00,45,46,47,11,12,13,14,00,00,00,00,00,00,00,00,00,00,00,00,00,00,00
00,00,00,00,00,20,21,22,23,24,00,00,00,00,00,00,00,00,00,00,00,00,00,00,00
00,00,00,00,00,30,31,32,33,34,00,00,00,00,00,00,00,00,00,00,00,00,00,00,05
40,00,00,60,44,40,41,42,43,44,00,00,60,00,00,00,00,00,00,00,00,00,00,00,15
00,00,00,00,00,00,00,00,00,00,00,00,00,00,00,00,00,00,00,00,00,00,00,00,25
00,00,00,00,00,00,00,00,60,00,00,00,00,00,00,00,00,00,00,00,00,00,00,00,35
00,00,00,01,02,03,04,00,00,00,00,00,00,00,00,00,00,00,00,00,00,00,00,00,45
00,00,10,11,12,13,09,00,00,00,00,00,00,00,60,00,00,00,00,00,00,00,09,00,00
00,00,20,21,22,23,24,00,00,00,00,00,00,00,00,00,00,00,00,00,00,00,00,00,05
00,00,30,31,32,33,34,00,00,00,00,00,00,00,00,00,00,00,00,00,00,00,00,00,15
00,00,40,41,42,43,44,00,60,00,00,00,00,00,00,00,00,00,00,00,00,00,00,00,25
00,05,06,07,00,00,00,00,00,00,00,00,00,00,00,00,00,00,00,00,00,00,00,00,35
00,15,16,17,00,00,00,09,00,00,00,00,00,00,00,00,00,00,00,00,00,00,00,00,45
00,25,26,27,00,00,00,00,00,00,05,06,07,00,00,00,00,00,00,00,00,00,00,00,00
00,35,36,37,01,02,03,04,00,00,15,16,17,00,00,00,00,00,00,09,00,00,00,00,00
00,45,46,47,11,12,13,60,00,00,25,26,27,00,00,00,00,00,00,00,00,00,00,00,10
00,00,00,20,21,22,23,24,00,00,35,36,37,00,00,00,00,00,00,00,00,00,00,00,20
00,00,00,30,31,32,33,34,00,00,45,46,47,00,00,00,00,00,00,00,00,00,00,00,30
00,00,00,40,41,42,43,44,00,09,00,00,00,00,00,00,00,00,09,00,00,00,00,00,40
00,00,00,00,00,00,00,00,00,00,00,00,00,00,00,00,00,00,00,00,00,00,00,00,00

2,0,0,0,2,0,0,0,0,0,2,0,0,0,0,0,0,0,0,2,2,2,2,2,2
2,0,0,0,0,0,0,0,0,0,2,0,0,0,0,0,0,0,0,2,2,2,2,2,2
2,0,0,0,0,0,0,0,0,0,2,0,0,0,0,0,0,0,0,2,0,0,0,0,0
2,0,0,0,0,0,0,2,0,0,2,0,0,0,0,0,0,0,0,2,0,0,0,0,0
2,0,0,0,0,0,0,0,0,0,2,0,0,0,0,0,0,0,0,2,0,0,0,0,0
2,0,0,0,0,0,0,0,0,0,2,0,0,0,0,0,0,0,0,2,0,0,0,0,0
2,0,0,0,0,0,0,0,0,0,2,0,0,0,0,0,2,2,0,2,0,0,0,0,0
2,0,0,0,0,0,2,0,0,0,2,0,0,0,0,0,2,2,0,2,0,0,2,0,0
2,0,0,0,0,0,0,0,0,0,2,0,0,0,0,0,0,0,0,2,0,0,0,0,0
2,0,0,0,0,0,0,0,0,0,2,0,0,0,0,0,0,0,0,2,0,0,0,0,0
2,0,0,0,2,0,0,0,0,0,2,2,2,2,2,2,2,2,2,2,0,0,0,0,0
2,0,0,0,0,0,0,0,0,0,2,2,2,2,2,2,2,2,2,2,0,0,0,0,0
2,0,0,0,0,0,0,2,0,0,0,0,0,0,0,0,0,0,0,0,0,0,0,0,0
2,0,0,0,0,0,0,0,0,0,0,0,0,0,0,0,0,0,0,0,0,0,0,0,0
2,0,0,0,0,0,0,0,0,0,0,0,0,0,0,0,0,0,0,2,0,0,0,0,0
2,0,2,0,0,0,0,0,0,0,0,0,0,0,0,0,0,0,0,0,0,0,0,0,0
2,0,0,0,0,0,0,0,0,0,0,0,0,0,0,0,0,0,0,0,0,0,0,0,0
2,0,0,0,0,0,0,0,0,0,0,2,0,0,0,0,0,0,0,0,0,0,0,0,0
2,0,0,0,0,2,0,0,0,2,0,0,0,0,0,0,0,0,2,0,0,0,0,0,0
2,2,2,2,2,2,2,2,2,2,2,2,2,2,2,2,2,2,2,2,2,2,2,2,2