00,00,00,00,00,00,00,00,00,00,00,48,49,00,00,00,00,00,00,00,00,00,00,00,00
00,02,06,01,00,00,00,00,00,00,02,58,59,00,02,06,01,00,00,00,02,00,00,00,00
00,35,00,03,00,02,00,02,06,01,02,51,51,00,02,00,03,03,01,03,02,00,00,00,00
00,00,00,24,00,35,00,02,00,03,00,51,51,00,00,00,00,00,03,00,35,00,02,03,00
00,00,00,00,00,00,00,00,00,00,00,51,51,01,00,02,06,24,00,00,00,00,02,00,00
00,00,00,06,01,03,03,03,03,50,51,51,51,51,52,02,00,03,00,02,24,00,00,00,00
00,00,00,00,03,00,02,00,00,60,61,61,61,61,62,00,01,04,00,02,00,00,00,00,00
00,00,00,10,10,10,10,10,10,10,10,10,06,01,00,03,03,00,00,00,01,00,00,00,00
00,00,00,10,10,10,10,10,10,10,10,10,00,03,02,03,01,00,02,06,24,00,00,00,00
00,00,00,10,10,10,10,10,10,10,10,10,01,04,02,00,03,00,02,00,03,00,00,00,00
00,00,00,00,03,00,02,06,00,00,01,04,06,00,00,00,00,00,00,00,00,00,00,00,00
00,00,00,01,04,00,02,24,03,00,00,02,00,00,02,06,00,00,00,00,00,00,00,00,00
00,00,00,00,00,00,00,01,04,00,00,00,10,10,10,10,10,10,10,14,00,00,00,00,00
00,00,08,09,01,00,02,00,02,00,02,00,10,10,10,10,10,10,10,03,00,00,00,00,00
00,00,18,19,03,00,02,00,00,00,00,00,10,10,10,10,10,10,10,03,00,00,00,00,00
00,00,28,29,04,00,00,00,00,02,03,01,00,01,00,00,00,00,00,01,00,00,00,00,00
00,00,00,00,00,00,02,06,00,02,00,03,00,00,00,02,06,00,00,00,00,00,00,00,00
00,00,02,06,01,00,02,00,03,03,01,04,06,00,00,00,00,00,02,03,00,00,00,00,00
00,00,02,00,03,00,00,01,03,02,06,01,00,00,02,03,01,00,02,00,00,00,00,00,00
00,00,00,01,04,00,00,01,00,02,00,03,01,00,02,00,03,00,00,01,00,00,00,00,00

47,48,40,41,42,43,44,45,46,44,46,00,00,43,44,45,46,47,48,48,40,41,42,43,44
57,58,50,51,52,53,54,55,56,54,56,00,00,53,54,55,56,57,58,58,50,51,52,53,54
00,00,00,00,00,00,00,00,00,00,00,07,00,00,00,00,00,00,00,00,00,00,00,00,00
00,00,00,00,00,00,00,00,00,00,00,07,00,00,00,00,00,00,00,00,00,00,00,00,00
00,00,00,00,00,00,00,00,00,00,00,27,00,00,00,00,00,00,00,00,00,00,00,00,00
01,01,01,01,01,01,01,01,01,01,01,37,33,34,35,36,34,35,36,34,35,36,34,35,36
00,00,00,00,00,00,00,00,00,00,00,00,00,00,00,00,00,00,00,00,00,00,00,00,00
00,00,00,00,00,00,00,00,00,00,00,00,00,00,00,00,00,00,00,00,00,00,00,00,00
00,00,00,00,00,00,00,00,00,00,00,00,00,00,00,00,00,00,00,00,00,00,00,00,00
00,00,00,00,00,00,00,00,00,00,00,00,00,00,00,00,00,00,00,00,00,00,00,00,00
00,00,00,00,00,00,00,00,00,00,00,00,00,00,00,00,00,00,00,00,00,00,00,00,00
00,00,00,00,00,00,00,00,00,00,00,00,00,00,00,00,00,00,00,00,00,00,00,00,00
00,00,00,00,00,00,00,00,00,00,00,00,00,00,00,00,00,00,00,00,00,00,00,00,00
05,05,00,00,42,08,00,00,00,00,00,00,00,00,00,00,00,00,00,00,00,00,00,00,00
05,05,00,00,52,08,00,00,00,00,00,00,00,00,00,00,00,00,00,00,00,00,00,00,00
00,00,00,00,00,08,00,00,00,00,00,00,00,00,00,00,00,00,00,00,00,00,00,00,00
00,00,00,00,00,08,00,00,00,00,00,00,00,00,00,00,00,00,00,00,00,00,00,00,00
00,00,00,00,00,08,00,00,00,00,00,00,00,00,00,00,00,00,00,00,00,00,00,00,00
00,00,00,00,00,08,00,00,00,00,00,00,00,00,00,00,00,00,00,00,00,00,00,00,00
00,00,00,00,00,08,00,00,00,00,00,00,00,00,00,00,00,00,00,00,00,00,00,00,00

00,00,00,00,00,00,00,00,00,00,00,00,00,00,00,00,00,00,00,00,00,00,00,00,00
00,00,00,00,00,00,00,00,00,00,00,00,00,00,00,00,00,00,00,00,00,00,00,00,00
00,00,00,00,00,00,00,00,00,00,00,00,00,00,00,00,00,00,00,00,00,00,00,00,00
00,00,00,00,00,00,00,00,00,00,00,08,08,00,00,00,00,00,00,00,00,00,00,00,00
00,00,00,00,00,00,00,00,00,00,00,18,18,00,00,00,00,00,00,00,00,00,00,00,00
00,00,00,00,00,00,00,00,00,00,00,00,00,00,00,00,00,00,00,00,00,00,00,00,00
00,00,00,00,00,00,00,00,00,00,00,00,00,00,00,00,00,00,00,00,00,00,00,00,00
00,00,00,00,00,00,00,00,00,00,00,00,00,00,00,00,00,00,00,00,00,00,00,00,00
00,00,00,00,00,11,00,11,00,11,00,00,00,00,00,00,00,00,00,00,00,00,00,00,00
00,00,00,00,00,00,00,00,00,00,00,00,00,00,00,00,00,00,00,00,00,00,00,00,00
00,00,00,00,00,00,00,00,00,00,00,00,00,00,00,00,00,00,00,00,00,00,00,00,00
00,00,00,00,00,00,00,00,00,00,00,00,00,00,00,00,00,00,00,00,00,00,00,00,00
00,00,00,00,00,00,00,00,00,00,00,00,00,00,00,00,00,00,00,00,00,00,00,00,00
00,00,00,00,00,00,00,00,00,00,00,00,00,00,11,00,11,00,00,00,00,00,00,00,00
00,00,00,00,00,00,00,00,00,97,00,00,00,00,00,00,00,00,00,00,00,00,00,00,00
00,00,00,00,00,00,00,00,00,00,00,00,00,00,00,00,00,00,00,00,00,00,00,00,00
00,00,00,00,00,00,00,00,00,00,00,00,00,00,00,00,00,00,00,00,00,00,00,00,00
00,00,00,00,00,00,00,00,00,00,00,00,00,00,00,00,00,00,00,00,00,00,00,00,00
00,00,00,00,00,00,00,00,00,00,00,00,00,00,00,00,00,00,00,00,00,00,00,00,00
00,00,00,00,00,00,00,00,00,00,00,00,96,00,00,00,00,00,00,00,00,00,98,00,00

00,00,00,05,06,07,00,00,00,00,00,00,00,00,15,16,17,00,00,00,00,00,00,00,00
00,00,00,15,16,17,00,00,00,00,00,00,00,00,25,26,27,00,00,00,00,00,00,00,00
00,60,00,25,26,27,00,00,00,00,00,00,00,00,35,36,37,00,00,00,00,00,00,00,00
00,00,00,35,36,37,00,00,00,00,00,00,00,00,45,46,47,00,00,00,60,00,00,00,60
00,00,00,45,46,47,00,00,00,00,00,00,00,00,00,00,00,00,00,00,00,00,00,60,60
00,00,00,00,00,00,00,00,00,00,00,00,00,00,00,00,00,00,00,00,00,00,00,00,00
00,00,00,00,00,00,00,00,00,00,00,00,00,00,00,00,00,00,00,00,00,00,00,00,00
00,00,00,00,00,00,00,00,00,00,00,00,00,00,00,00,00,00,00,00,00,00,00,00,00
00,00,00,00,00,00,00,00,00,00,00,00,00,00,00,00,00,00,00,00,00,00,00,00,00
00,00,00,00,00,00,00,00,00,00,00,00,00,00,00,00,00,00,00,00,00,00,00,00,00
00,00,00,00,00,00,00,00,00,00,00,00,00,00,00,00,00,00,00,00,00,00,00,00,00
00,00,00,00,00,00,00,00,00,00,00,00,00,00,00,00,00,00,00,00,00,00,00,00,00
00,00,00,00,00,00,00,00,00,00,00,00,00,00,00,00,00,00,00,00,00,00,00,00,00
00,00,00,00,00,00,00,00,00,00,00,00,00,00,00,00,00,00,00,00,00,00,00,00,00
00,00,00,00,00,00,00,00,00,00,00,00,00,00,00,00,00,00,00,00,00,00,00,00,00
00,00,00,00,00,00,00,00,00,00,00,00,00,00,00,00,00,00,00,00,00,00,00,00,00
09,09,00,00,00,00,00,00,00,00,00,00,00,00,00,00,00,00,00,00,00,00,00,00,00
14,09,00,00,00,00,00,00,00,00,00,00,00,00,00,00,00,00,00,00,00,00,00,00,00
24,00,00,00,00,00,00,00,00,00,00,00,00,00,00,00,00,00,00,00,00,00,00,00,00
05,06,07,00,00,00,00,00,00,00,00,00,00,00,00,00,00,00,00,00,00,00,00,00,00

2,2,2,2,2,2,2,2,2,2,2,2,2,2,2,2,2,2,2,2,2,2,2,2,2
2,2,2,2,2,2,2,2,2,2,2,0,0,2,2,2,2,2,2,2,2,2,2,2,2
0,0,0,0,0,0,0,0,0,0,2,0,0,2,0,0,0,0,0,0,0,0,0,0,0
0,0,0,0,0,0,0,0,0,0,2,0,0,2,0,2,0,0,0,0,0,0,0,0,0
0,0,0,0,2,0,0,0,0,0,2,0,0,2,0,0,0,0,0,0,0,0,0,0,0
2,2,2,2,2,2,2,2,2,2,2,0,0,2,2,2,2,2,2,2,2,2,2,2,2
0,0,0,0,0,0,0,0,0,0,0,0,0,0,0,0,0,0,0,0,0,0,0,0,0
0,0,0,0,0,0,0,0,0,0,0,0,0,0,0,0,0,0,0,0,0,0,0,0,0
0,0,0,0,0,2,0,2,0,2,0,0,0,0,0,0,0,0,0,0,0,0,0,0,0
0,0,0,0,0,0,0,0,0,0,0,0,0,0,0,0,0,0,0,0,0,0,0,0,0
0,0,0,0,0,0,0,0,0,0,0,0,0,0,0,0,0,0,0,0,0,0,0,0,0
0,0,0,0,0,0,0,0,0,0,0,0,0,0,0,0,0,0,0,0,0,0,0,0,0
0,0,0,0,0,0,0,0,0,0,0,0,0,0,0,0,0,0,0,0,0,0,0,0,0
2,2,0,0,2,2,0,0,0,0,0,0,0,0,2,0,2,0,0,0,0,0,0,0,0
2,2,0,0,2,2,0,0,0,2,0,0,0,0,0,0,0,0,0,0,0,0,0,0,0
0,0,0,0,0,2,0,0,0,0,0,0,0,0,0,0,0,0,0,0,0,0,0,0,0
2,2,0,0,0,2,0,0,0,0,0,0,0,0,0,0,0,0,0,0,0,0,0,0,0
0,2,0,0,0,2,0,0,0,0,0,0,0,0,0,0,0,0,0,0,0,0,0,0,0
0,0,0,0,0,2,0,0,0,0,0,0,0,0,0,0,0,0,0,0,0,0,0,0,0
0,0,0,0,0,2,0,0,0,0,0,0,0,0,0,0,0,0,0,0,0,0,2,0,0