00,35,01,01,01,00,00,00,00,00,01,04,00,00,00,01,04,00,00,00,00,00,00,00,00
00,00,02,01,01,00,00,00,00,00,00,00,00,00,00,00,00,00,00,00,00,00,00,00,00
00,00,02,00,00,00,00,00,00,00,00,00,00,00,00,00,20,20,00,00,00,00,00,00,00
00,00,02,00,00,00,00,00,00,00,30,00,00,00,00,00,00,00,00,00,00,00,00,00,00
00,00,02,00,00,00,00,00,00,20,20,00,00,00,00,00,00,21,20,12,00,00,00,00,00
00,00,00,00,00,00,00,00,00,20,20,00,00,00,00,00,00,20,20,12,00,00,00,00,00
00,00,00,00,00,00,00,31,20,20,20,00,00,00,00,20,20,20,00,00,00,00,00,00,00
00,00,00,00,00,00,00,20,20,22,00,00,00,00,00,20,00,00,00,00,20,00,00,00,00
00,00,00,00,00,00,20,20,00,00,01,01,01,01,01,00,00,00,00,00,20,12,00,00,00
00,00,00,00,00,20,20,00,00,00,08,09,10,38,39,00,00,00,00,11,12,12,00,00,00
00,00,00,00,31,20,22,00,00,00,48,49,20,48,49,00,00,00,00,21,22,00,00,00,00
00,00,00,00,20,20,00,00,00,00,18,19,20,48,49,00,00,00,00,20,20,20,00,00,00
00,00,00,20,20,20,22,00,00,00,48,49,20,18,19,00,00,00,00,00,35,20,20,00,00
00,00,21,20,20,20,20,31,31,00,18,19,20,48,49,00,00,00,00,00,00,00,00,00,00
00,00,21,20,10,10,10,10,20,12,28,29,20,58,59,00,00,00,00,00,00,00,00,00,00
00,00,21,10,20,20,10,20,10,12,10,20,10,10,20,00,00,00,00,00,00,00,00,00,00
00,00,21,10,10,10,10,10,10,12,20,20,20,20,10,00,00,00,00,00,00,00,00,00,00
00,00,21,10,20,10,20,20,20,12,20,10,20,10,20,00,00,00,35,00,00,00,00,00,00
00,00,00,00,00,00,00,00,00,00,20,20,20,20,10,00,00,00,00,00,00,35,00,00,00
00,00,00,00,00,00,00,00,00,00,20,20,20,20,10,00,00,00,00,00,00,00,00,00,00

00,00,00,00,00,07,00,00,00,00,00,00,00,00,00,00,00,00,00,00,00,00,00,00,00
00,00,00,00,00,27,00,00,00,00,00,00,00,00,00,00,00,00,00,00,00,00,00,00,00
00,00,00,00,00,27,00,00,00,00,00,00,00,00,00,00,00,00,00,00,00,00,00,00,00
00,00,00,00,00,07,00,00,00,00,00,00,00,00,00,00,00,00,00,00,00,00,00,00,00
00,00,00,00,00,27,00,00,00,00,00,00,00,00,00,00,00,00,00,00,00,00,00,00,00
00,00,00,00,00,27,00,00,00,00,00,00,00,00,00,00,00,00,00,00,00,00,00,00,00
35,35,01,01,01,37,00,00,00,00,00,00,00,00,00,00,00,00,00,00,00,00,00,00,00
00,00,00,00,00,00,00,00,00,00,00,00,00,00,00,00,00,00,00,00,00,00,00,00,00
00,00,00,00,00,00,00,00,00,00,00,00,00,00,00,00,00,00,00,00,00,00,00,00,00
00,00,00,00,00,00,00,00,00,03,00,00,00,00,00,07,00,00,00,00,00,00,00,00,00
00,00,00,00,00,00,00,00,00,23,00,00,00,00,00,07,00,00,00,00,00,00,00,00,00
00,00,00,00,00,00,00,00,00,23,00,00,00,00,00,07,00,00,00,00,00,00,00,00,00
00,00,00,00,00,00,00,00,00,23,00,00,00,00,00,08,00,00,00,00,00,00,00,00,00
00,00,00,00,00,00,00,00,00,19,00,00,00,00,00,07,00,00,00,00,00,00,00,00,00
00,00,00,00,00,00,00,00,00,23,00,00,00,00,00,40,41,42,43,44,45,46,47,48,48
00,00,00,00,00,00,00,00,00,23,00,00,00,00,00,50,51,52,53,54,55,56,57,58,58
00,00,00,00,00,00,00,00,00,19,00,00,00,00,00,00,00,00,00,00,00,00,00,00,00
00,00,00,00,00,00,00,00,00,23,00,00,00,00,00,00,00,00,00,00,00,00,00,00,00
00,00,00,00,00,00,00,00,00,19,00,00,00,00,00,00,00,00,00,00,00,00,00,00,00
00,00,00,00,00,00,00,00,00,03,00,00,00,00,00,00,00,00,00,00,00,00,00,00,00

00,00,00,00,00,00,00,00,00,00,00,00,00,00,00,00,00,00,00,00,00,00,00,00,00
00,00,00,00,00,00,00,00,00,00,00,00,00,00,00,00,00,00,00,00,00,00,00,00,00
00,00,00,00,00,00,00,00,00,00,00,00,00,00,00,00,00,00,00,00,00,00,00,00,00
00,00,00,00,00,00,00,00,00,00,00,22,23,24,00,00,00,00,00,00,00,00,00,00,00
00,00,00,00,00,00,00,00,00,00,00,32,33,34,00,00,00,00,00,00,00,00,00,00,00
00,00,00,00,00,00,00,00,00,00,00,42,43,44,00,00,00,00,00,00,00,00,00,00,00
00,00,00,00,00,00,00,00,00,00,00,00,00,00,00,00,00,00,00,00,00,00,00,00,00
00,00,00,00,00,00,00,00,00,00,00,00,00,00,00,00,00,00,00,00,00,00,00,00,00
00,00,00,00,00,00,00,00,00,00,00,00,00,00,00,00,00,00,00,00,00,00,00,00,00
00,00,00,00,00,00,00,00,00,00,00,00,00,00,00,00,00,00,00,00,00,00,00,00,00
00,00,00,00,00,00,00,00,00,00,00,00,00,00,00,00,00,00,00,00,00,00,00,00,00
00,00,00,00,00,00,00,00,00,00,00,00,00,00,00,00,00,00,00,00,00,00,00,00,00
00,00,00,00,00,00,00,00,00,00,00,00,00,00,00,00,00,00,00,00,00,00,00,00,00
00,00,00,00,00,00,00,00,00,00,00,00,00,00,00,00,00,00,00,00,00,00,00,00,00
00,00,00,00,00,00,00,00,00,00,00,00,00,00,00,00,00,00,00,00,00,00,00,00,00
00,00,00,00,00,00,00,00,00,00,00,00,00,00,00,00,00,00,00,00,00,00,00,00,00
00,00,00,00,00,00,00,00,00,00,00,00,00,00,00,00,00,00,00,00,00,00,00,00,00
00,00,00,00,00,00,00,00,00,00,00,00,00,00,00,00,00,00,00,00,00,00,00,00,00
00,00,00,00,00,00,00,00,00,00,00,00,00,00,00,00,00,00,00,00,00,00,00,00,00
00,00,00,00,00,00,00,00,00,00,00,00,00,00,00,00,00,00,00,00,00,00,00,00,00

15,16,17,00,00,00,00,00,00,00,00,00,00,00,00,00,00,00,00,00,00,00,00,00,00
25,26,27,00,00,00,00,00,00,00,00,00,00,00,00,00,00,00,00,00,00,00,00,00,00
35,36,37,00,00,00,00,00,00,00,00,00,00,00,00,00,00,00,00,00,00,00,00,00,00
45,46,47,00,00,00,00,00,00,00,00,00,00,00,00,00,00,00,00,00,00,00,00,00,00
00,00,00,00,00,00,00,00,00,00,00,00,00,00,00,00,00,00,00,00,00,00,50,00,00
00,00,00,00,00,00,00,00,00,00,00,00,00,00,00,00,00,00,00,00,00,00,00,00,00
00,00,00,00,00,00,00,00,00,00,00,00,00,00,00,00,00,00,00,00,00,00,00,00,00
00,00,00,00,00,00,00,00,00,00,00,00,00,00,00,00,00,00,00,00,00,00,00,00,00
00,00,00,00,00,00,00,00,00,00,00,00,00,00,00,00,00,00,00,00,00,00,00,00,50
00,00,00,00,00,00,00,00,00,00,00,00,00,00,00,00,00,00,00,00,00,00,00,00,00
00,00,00,00,00,00,00,00,00,00,00,00,00,00,00,00,00,00,00,00,00,00,00,00,00
00,00,00,00,00,00,00,00,00,00,00,00,00,00,00,00,00,00,00,00,00,00,00,00,00
00,00,00,00,00,00,00,00,00,00,00,00,00,00,00,00,01,02,03,04,00,00,00,00,00
00,00,00,00,00,00,00,00,00,00,00,00,00,00,00,10,11,12,13,14,00,00,00,00,00
00,00,00,00,00,00,00,00,00,00,00,00,00,00,00,20,21,22,23,24,05,06,07,00,00
00,00,00,00,00,00,00,00,00,00,00,00,00,00,00,30,31,32,33,34,15,16,17,00,00
00,00,00,00,00,00,00,00,00,00,00,00,00,00,00,40,41,42,43,44,25,26,27,00,00
00,00,00,00,00,00,00,00,00,00,00,00,00,00,00,00,00,00,00,00,35,36,37,00,09
00,00,00,00,00,00,00,00,00,00,00,00,00,00,00,50,00,00,00,00,45,74,47,00,00
00,00,00,00,00,00,00,00,00,00,00,00,00,00,00,00,00,00,00,00,00,00,00,00,00

0,0,0,0,0,2,0,0,0,0,0,0,0,0,0,0,0,0,0,0,0,0,0,0,0
0,0,0,0,0,2,0,0,0,0,0,0,0,0,0,0,0,0,0,0,0,0,0,0,0
0,0,0,0,0,2,0,0,0,0,0,0,0,0,0,0,0,0,0,0,0,0,0,0,0
0,2,0,0,0,2,0,0,0,0,0,0,0,0,0,0,0,0,0,0,0,0,0,0,0
0,0,0,0,0,2,0,0,0,0,0,0,0,0,0,0,0,0,0,0,0,0,0,0,0
0,0,0,0,0,2,0,0,0,0,0,0,0,0,0,0,0,0,0,0,0,0,0,0,0
2,2,2,2,2,2,0,0,0,0,0,0,0,0,0,0,0,0,0,0,0,0,0,0,0
0,0,0,0,0,0,0,0,0,0,0,0,0,0,0,0,0,0,0,0,0,0,0,0,0
0,0,0,0,0,0,0,0,0,0,0,0,0,0,0,0,0,0,0,0,0,0,0,0,0
0,0,0,0,0,0,0,0,0,2,0,0,0,0,0,2,0,0,0,0,0,0,0,0,0
0,0,0,0,0,0,0,0,0,2,0,0,0,0,0,2,0,0,0,0,0,0,0,0,0
0,0,0,0,0,0,0,0,0,2,0,0,0,0,0,2,0,0,0,0,0,0,0,0,0
0,0,0,0,0,0,0,0,0,2,0,0,0,0,0,2,0,0,0,0,0,0,0,0,0
0,0,0,0,0,0,0,0,0,2,0,0,0,0,0,2,0,0,0,0,0,0,0,0,0
0,0,0,0,0,0,0,0,0,2,0,0,0,0,0,2,2,2,2,2,2,2,2,2,2
0,0,0,0,0,0,0,0,0,2,0,0,0,0,0,2,2,2,2,2,2,2,2,2,2
0,0,0,0,0,0,0,0,0,2,0,0,0,0,0,0,0,2,0,0,0,0,0,0,0
0,0,0,0,0,0,0,0,0,2,0,0,0,0,0,0,0,0,0,0,0,0,0,0,2
0,0,0,0,0,0,0,0,0,2,0,0,0,0,0,0,0,0,0,0,0,2,0,0,0
0,0,0,0,0,0,0,0,0,2,0,0,0,0,0,0,0,0,0,0,0,0,0,0,0