00,01,01,01,01,01,01,01,01,01,20,10,20,10,20,01,01,01,01,01,01,01,01,01,01
00,01,01,01,01,01,01,01,01,01,10,20,20,10,10,01,01,01,01,01,01,01,01,01,01
00,00,24,00,00,00,00,00,00,11,10,10,10,10,10,12,00,24,00,00,00,00,00,00,00
00,00,00,00,06,00,00,00,00,11,10,10,10,10,10,12,00,00,00,00,00,00,24,00,00
00,00,00,00,00,00,00,00,00,11,10,10,10,10,10,12,00,00,00,00,00,00,00,00,00
00,00,00,00,00,00,00,00,20,20,10,10,10,10,10,10,20,00,00,00,00,06,35,00,15
00,00,00,00,00,00,00,00,10,00,10,10,10,10,10,00,10,00,00,00,00,00,34,00,00
00,00,00,00,00,00,00,01,20,10,10,20,10,10,10,20,20,01,01,00,00,00,00,00,00
00,00,00,26,00,00,00,20,10,10,20,20,10,10,10,10,20,10,01,00,00,00,00,00,00
00,00,00,00,00,00,00,10,10,10,10,40,41,42,10,20,10,10,12,00,00,24,00,00,00
00,00,00,00,00,00,11,10,10,10,10,50,51,52,10,10,10,10,12,00,00,24,00,00,00
00,00,00,00,00,01,11,10,20,10,10,50,51,52,20,10,20,10,12,00,24,24,00,00,00
00,00,00,00,00,01,11,10,10,10,10,60,61,62,10,10,10,20,12,00,24,00,00,00,00
00,00,00,00,00,01,21,20,10,20,10,10,10,20,20,20,10,10,22,15,15,00,00,00,00
00,00,00,00,00,01,20,20,10,10,10,10,10,10,10,10,20,10,20,00,00,15,00,00,00
00,00,00,00,00,01,10,01,10,10,10,10,10,10,10,10,10,34,10,00,00,00,35,00,26
00,00,00,00,00,15,10,20,10,33,33,33,33,33,33,33,20,10,10,00,00,00,00,00,00
00,00,35,00,00,00,00,00,00,00,00,00,00,00,00,00,00,25,00,00,00,00,00,00,00
00,00,00,00,00,00,00,00,00,00,00,00,00,00,00,00,00,00,00,35,00,00,00,00,00
00,00,00,00,00,00,00,00,00,00,00,00,00,00,00,00,00,00,00,00,00,00,00,00,00

43,43,43,44,45,43,44,45,43,44,45,60,36,61,43,44,45,43,44,45,43,43,44,45,41
52,52,53,54,55,53,54,55,53,54,55,70,00,71,53,54,55,53,54,55,53,53,54,55,51
00,00,00,00,00,00,00,00,00,00,00,08,00,00,00,00,00,00,00,00,00,00,00,00,00
00,00,00,00,00,00,00,00,00,00,00,08,00,19,00,00,00,00,00,00,00,00,00,00,00
00,00,00,00,00,00,00,00,00,00,00,28,00,29,00,00,00,00,00,00,00,00,00,00,00
00,00,00,00,00,00,00,00,00,00,00,08,00,00,00,00,00,00,00,00,00,00,00,00,00
00,00,00,00,00,00,00,00,00,00,00,08,00,19,00,00,00,00,00,00,00,00,00,00,00
00,00,00,00,00,00,00,00,00,00,00,28,00,29,00,00,00,00,00,00,00,00,00,00,00
00,00,00,00,00,00,00,00,03,34,35,37,00,33,35,34,07,00,00,00,00,00,00,00,00
00,00,00,00,00,00,00,00,03,00,00,00,00,00,00,00,07,00,00,00,00,00,00,00,00
00,00,00,00,00,00,00,00,03,00,00,00,00,00,00,00,27,00,00,00,00,00,00,00,00
00,00,00,00,00,00,00,00,03,00,00,00,00,00,00,00,27,00,00,00,00,00,00,00,00
00,00,00,00,00,00,00,00,23,00,00,00,00,00,00,00,27,00,00,00,00,00,00,00,00
00,00,00,00,00,00,00,00,29,00,00,00,00,00,00,00,27,00,00,00,00,00,00,00,00
00,00,00,00,00,00,00,00,33,34,34,34,34,34,34,35,37,00,00,00,00,00,00,00,00
00,00,00,00,00,00,00,00,00,00,00,00,00,00,00,00,00,00,00,00,00,00,00,00,00
00,00,00,00,00,00,00,00,00,00,00,00,00,00,00,00,00,00,00,00,00,00,00,00,00
00,00,00,00,00,00,00,00,00,00,00,00,00,00,00,00,00,00,00,00,00,00,00,00,00
00,00,00,00,00,00,00,00,00,00,00,00,00,00,00,00,00,00,00,00,00,00,00,00,00
00,00,00,00,00,00,00,00,00,00,00,00,00,00,00,00,00,00,00,00,00,00,00,00,00

00,00,00,00,00,00,00,00,00,00,00,00,00,00,00,00,00,00,00,00,00,00,00,00,00
00,00,00,00,00,00,00,00,00,00,00,00,00,00,00,00,00,00,00,00,00,00,00,00,00
00,00,00,00,00,00,00,00,00,00,00,00,00,00,00,00,00,00,00,00,00,00,00,00,00
00,00,00,00,00,00,00,00,00,00,00,00,00,00,00,00,00,00,00,00,00,00,00,00,00
00,00,00,00,00,00,00,00,00,00,00,00,00,00,00,00,00,00,00,00,00,00,00,00,00
00,00,00,00,00,00,00,00,00,00,00,00,00,00,00,00,00,00,00,00,00,00,00,00,00
00,00,00,00,00,00,00,00,00,00,00,00,00,00,00,00,00,00,00,00,00,00,00,00,00
00,00,00,00,00,00,00,00,00,00,00,00,00,00,00,00,00,00,00,00,00,00,00,00,00
00,00,00,00,00,00,00,00,00,00,00,00,00,00,00,00,00,00,00,00,00,00,00,00,00
00,00,00,00,00,00,00,00,00,00,00,77,49,77,00,00,00,00,00,00,00,00,00,00,00
00,00,00,00,00,00,00,00,00,00,00,87,59,87,00,00,00,00,00,00,00,00,00,00,00
00,00,00,00,00,00,00,00,00,00,00,00,69,00,00,00,00,00,00,00,00,00,00,00,00
00,00,00,00,00,00,00,00,00,00,00,00,00,00,00,00,00,00,00,00,00,00,00,00,00
00,00,00,00,00,00,00,00,00,00,00,00,00,00,00,00,00,00,00,00,00,00,00,00,00
00,00,00,00,00,00,00,00,00,00,00,00,00,00,00,00,00,00,00,00,00,00,00,00,00
00,00,00,00,00,00,00,00,00,00,00,00,00,00,00,00,00,00,00,00,00,00,00,00,00
00,00,00,00,00,00,00,00,00,00,00,00,00,00,00,00,00,00,00,00,00,00,00,00,00
00,00,00,00,00,00,00,00,00,00,00,00,00,00,00,00,00,00,00,00,00,00,00,00,00
00,00,00,00,00,00,00,00,00,00,00,00,00,00,00,00,00,00,00,00,00,00,00,00,00
00,00,00,00,00,00,00,00,00,00,00,00,00,00,00,00,00,00,00,00,00,00,00,00,00

00,00,00,01,02,03,04,00,00,00,00,00,00,00,00,00,00,00,00,00,00,00,00,00,00
00,00,10,11,12,13,14,00,00,00,00,00,00,00,00,00,00,00,00,00,00,00,00,00,00
06,07,20,21,22,23,24,00,05,06,07,00,00,00,05,06,07,00,00,00,00,00,00,00,00
16,17,30,31,32,33,34,00,15,16,17,00,00,00,15,16,17,00,50,00,00,00,00,00,00
26,27,40,41,42,43,44,00,25,26,27,00,00,00,25,26,27,00,00,00,51,00,00,00,00
36,37,00,00,00,00,00,00,35,36,37,00,00,00,35,36,37,00,00,00,00,00,00,05,06
46,47,00,50,00,51,00,00,45,46,47,00,00,00,45,46,47,00,00,00,00,00,51,15,16
00,00,00,00,00,00,00,00,00,00,00,00,00,00,00,00,00,00,00,00,00,00,00,25,26
06,07,00,00,00,00,00,00,00,00,00,00,00,00,00,00,00,00,00,00,51,00,00,35,36
16,17,00,00,00,00,00,00,00,00,00,00,00,00,00,00,00,00,00,00,00,00,00,45,46
26,27,00,00,00,00,00,00,00,00,00,00,00,00,00,00,00,00,00,00,00,00,00,51,00
36,37,00,00,00,00,05,06,07,00,00,00,00,00,00,00,05,06,07,00,00,00,00,00,00
46,47,50,09,00,00,15,16,17,00,00,00,00,00,00,00,15,16,17,00,00,00,00,00,00
00,00,00,00,51,00,25,26,27,00,00,00,00,00,00,00,25,26,27,00,00,00,00,00,00
01,02,03,04,00,00,35,36,37,00,00,00,00,00,00,00,35,36,37,00,00,00,00,00,00
11,12,13,14,00,00,45,46,47,00,00,00,00,00,00,00,45,46,47,00,00,00,00,00,05
21,22,23,24,00,00,00,00,00,00,00,00,00,00,00,00,00,00,00,00,00,00,00,00,15
31,32,33,50,00,00,00,00,00,00,00,00,50,00,00,00,00,00,00,00,00,00,51,00,25
41,42,43,44,00,00,00,51,00,50,50,00,51,05,06,07,00,00,00,00,00,00,00,00,35
00,00,00,00,00,00,00,00,00,00,00,00,00,15,16,17,00,00,00,00,00,00,00,00,45

2,2,2,2,2,2,2,2,2,2,2,2,0,2,2,2,2,2,2,2,2,2,2,2,2
2,2,2,2,2,2,2,2,2,2,2,0,0,0,2,2,2,2,2,2,2,2,2,2,2
0,0,0,0,0,0,0,0,0,0,2,0,0,0,2,0,0,0,0,0,0,0,0,0,0
0,0,0,0,0,0,0,0,0,0,2,0,0,0,2,0,0,0,0,0,0,0,0,0,0
0,0,0,0,2,0,0,0,0,0,2,0,0,0,2,0,0,0,0,0,0,0,0,0,0
0,0,0,0,0,0,0,0,0,0,2,0,0,0,2,0,0,0,0,0,0,0,0,0,0
2,0,0,0,0,0,0,0,0,2,2,0,0,0,2,2,0,0,0,0,0,0,0,0,0
0,0,0,0,0,0,0,0,2,2,2,0,0,0,2,2,2,0,0,0,0,0,0,0,0
0,0,0,0,0,0,0,0,2,0,0,0,0,0,0,0,2,0,0,0,0,0,0,0,0
0,0,0,0,0,0,0,0,2,0,0,0,0,0,0,0,2,0,0,0,0,0,0,0,2
0,0,0,0,0,0,0,0,2,0,0,2,2,2,0,0,2,0,0,0,0,0,0,0,0
0,0,0,0,0,0,0,0,2,0,0,0,2,0,0,0,2,0,0,0,0,0,0,0,0
2,0,0,2,0,0,0,0,2,0,0,0,0,0,0,0,2,0,0,0,0,0,0,0,0
0,0,0,0,0,0,0,0,2,0,0,0,0,0,0,0,2,0,0,0,0,0,0,0,0
0,0,0,0,0,0,0,0,2,2,2,2,2,2,2,2,2,0,0,0,0,0,0,0,0
0,0,0,0,0,0,0,2,0,0,0,0,0,0,0,0,0,2,0,0,0,0,0,0,0
0,0,0,0,0,0,0,0,0,0,0,0,0,0,0,0,0,0,0,0,0,0,0,0,0
0,0,0,0,0,0,0,0,0,0,0,0,0,0,0,0,0,0,0,0,0,0,0,0,0
0,2,0,0,0,0,0,0,0,0,0,0,0,0,0,0,0,0,0,0,0,0,0,0,0
2,2,2,2,2,2,2,2,2,2,2,2,2,2,2,2,2,2,2,2,2,2,2,2,2